00001000000000000000100000
00001000000000000000100000
00001000100000110000100000
00001021000011100000100000
00001000012110000000100000
00001000001100000000100000
00001000000000000120100000
00001000001100002011100000
00001000011111000000100000
00001000001111100000100000
00001000002111000000100000
00001000011100000000100000
00001000000001000000100000
00001000000001121000100000
00001000000001110000100000
00001111000000100000100000
00001001100000200000100000
00001002100000000000100000
00001000000000000000100000
000010000000*0000000100000
