00001000000000000000100000
00001000000*00000000100000
00001000000000000000100000
00001000000000000000100000
00001000000000000000100000
00001000000000000000100000
00001000000000000000100000
00001000000000000000100000
00001000000000000000100000
00001000000000000000100000
00001000000000000000100000
00001000000000000000100000
00001000000000000000100000
00001000000000000000100000
00001000000000020000100000
00001000000000000000100000
00001000000000000000100000
00001000000000000000100000
00001000000000000000100000
000010000000*0000000100000
