00001000000000000000100000
00001000000*00000000100000
00001000000000000000100000
00001000000000000000100000
00001000000000000000100000
00001000000000000000100000
00001000000000000000100000
00001000000000000000100000
00001000000000000000100000
00001000000000000000100000
00001000000000000000100000
00001000000000000000100000
00001000000000000000100000
00001000000000000000100000
00001000000000002000100000
00001000000000000000100000
00001000000000000000100000
00001000000000000000100000
00001000000000000000100000
00001000000000000000100000
