00001000000000000000100000
00001000000000000000100000
00001000100000100000100000
00001001110001100000100000
00001000100011000000100000
00001010000110010000100000
00001001131100011100100000
00001000010000000003100000
00001020011000000011100000
00001000002101110010100000
00001000410000012110100000
00001444111102011000100000
00001444001100000000100000
00001444004400111000100000
00001003110000001100100000
00001000010000000200100000
00001000011000110000100000
00001000010000010000100000
00001002000000001000100000
00001000000100002000100000
00001000001100110000100000
00001000011000011400100000
00001444444444441444100000
00001440014000044402100000
00001400011121004000100000
00001000031110001000100000
00001000101100001100100000
00001000000000000110100000
00001000000011110010100000
00001000001100011000100000
00001100001201001130100000
00001111100011000000100000
00001111111110000000100000
00001000011111111000100000
00001000000000011100100000
00001000000011201000100000
00001003000111001000100000
00001000001111100020100000
00001000444411100000100000
00001001110000100000100000
00001000000020144444100000
00001111111000144444100000
0000100***1101110030100000
0000100***0000100000100000
0000100***1111100200100000
00001000110020440000100000
00001000000000044000100000
00001000000000004400100000
